Date,District Name,Today’s Positives,Total Positives,Today’s Discharges,Total Discharges,Total Active Cases,Today’s Reported Covid Deaths,Total Covid Deaths,Death due to Non- Covid reasons
2020-07-01,Chamarajanagara,21,54,0,1,53,0,0,0
2020-07-02,Chamarajanagara,0,54,0,1,53,0,0,0
2020-07-03,Chamarajanagara,24,78,0,1,77,0,0,0
2020-07-04,Chamarajanagara,5,83,0,1,82,0,0,0
2020-07-05,Chamarajanagara,19,102,0,1,101,0,0,0
2020-07-06,Chamarajanagara,12,114,3,4,110,0,0,0
2020-07-07,Chamarajanagara,6,120,20,24,96,0,0,0
2020-07-08,Chamarajanagara,0,120,7,31,89,0,0,0
2020-07-10,Chamarajanagara,9,141,18,49,92,0,0,0
2020-07-11,Chamarajanagara,17,158,0,49,109,0,0,0
2020-07-12,Chamarajanagara,13,171,0,49,121,1,1,0
2020-07-13,Chamarajanagara,9,180,28,77,102,0,1,0
2020-07-14,Chamarajanagara,8,188,16,93,92,2,3,0
2020-07-15,Chamarajanagara,8,196,17,110,83,0,3,0
2020-07-16,Chamarajanagara,16,212,6,116,93,0,3,0
2020-07-17,Chamarajanagara,10,222,19,135,84,0,3,0
2020-07-19,Chamarajanagara,25,281,39,174,104,0,3,0
2020-07-20,Chamarajanagara,49,330,13,187,140,0,3,0
2020-07-21,Chamarajanagara,34,364,11,198,162,1,4,0
2020-07-22,Chamarajanagara,31,395,12,210,180,1,5,0
2020-07-23,Chamarajanagara,27,422,22,232,185,0,5,0
2020-07-24,Chamarajanagara,33,455,0,232,217,1,6,0
2020-07-25,Chamarajanagara,22,477,18,250,221,0,6,0
2020-07-26,Chamarajanagara,28,505,20,270,229,0,6,0
2020-07-27,Chamarajanagara,16,521,18,288,227,0,6,0
2020-07-28,Chamarajanagara,52,573,31,319,248,0,6,0
2020-07-29,Chamarajanagara,20,593,15,334,253,0,6,0
2020-07-30,Chamarajanagara,32,625,30,364,255,0,6,0
2020-07-31,Chamarajanagara,44,669,36,400,262,1,7,0
2020-08-01,Chamarajanagara,43,712,15,415,290,0,7,0
2020-08-02,Chamarajanagara,31,743,48,463,271,2,9,0
2020-08-03,Chamarajanagara,52,795,31,494,291,1,10,0
2020-08-04,Chamarajanagara,57,852,23,517,322,3,13,0
2020-08-05,Chamarajanagara,38,890,28,545,332,0,13,0
2020-08-06,Chamarajanagara,95,985,21,566,405,1,14,0
2020-08-07,Chamarajanagara,63,1048,27,593,440,1,15,0
2020-08-08,Chamarajanagara,62,1110,40,633,459,3,18,0
2020-08-09,Chamarajanagara,47,1157,147,780,357,2,20,0
2020-08-10,Chamarajanagara,70,1227,35,815,391,1,21,0
2020-08-11,Chamarajanagara,72,1299,43,858,419,1,22,0
2020-08-12,Chamarajanagara,68,1367,67,925,417,3,25,0
2020-08-13,Chamarajanagara,56,1423,54,979,418,1,26,0
2020-08-14,Chamarajanagara,61,1484,67,1046,410,2,28,0
2020-08-15,Chamarajanagara,64,1548,27,1073,446,1,29,0
2020-08-16,Chamarajanagara,36,1584,70,1143,412,0,21,8
2020-08-17,Chamarajanagara,61,1645,51,1194,422,0,21,8
2020-08-18,Chamarajanagara,21,1666,52,1246,390,1,22,8
2020-08-19,Chamarajanagara,111,1777,106,1352,395,0,22,8
2020-08-20,Chamarajanagara,120,1897,34,1386,479,2,24,8
2020-08-21,Chamarajanagara,59,1956,0,1386,538,0,24,8
2020-08-22,Chamarajanagara,67,2023,71,1457,532,2,26,8
2020-08-23,Chamarajanagara,23,2046,46,1503,508,1,27,8
2020-08-24,Chamarajanagara,29,2075,25,1528,510,2,26,11
2020-08-25,Chamarajanagara,17,2092,19,1547,506,2,28,11
2020-08-26,Chamarajanagara,51,2143,88,1635,467,2,30,11
2020-08-27,Chamarajanagara,36,2179,31,1666,469,3,33,11
2020-08-28,Chamarajanagara,37,2216,36,1702,470,0,33,11
2020-08-29,Chamarajanagara,45,2261,27,1729,488,0,33,11
2020-08-30,Chamarajanagara,54,2315,12,1741,529,1,34,11
2020-08-31,Chamarajanagara,51,2366,47,1788,531,2,36,11
2020-09-01,Chamarajanagara,49,2415,61,1849,518,1,37,11
2020-09-02,Chamarajanagara,67,2482,64,1913,520,1,38,11
2020-09-03,Chamarajanagara,43,2525,68,1981,495,0,38,11
2020-09-04,Chamarajanagara,56,2581,70,2051,480,1,39,11
2020-09-06,Chamarajanagara,41,2653,27,2184,416,0,42,11
2020-09-07,Chamarajanagara,20,2673,35,2219,400,1,43,11
2020-09-08,Chamarajanagara,42,2715,62,2281,378,2,45,11
2020-09-09,Chamarajanagara,60,2775,41,2322,396,1,46,11
2020-09-10,Chamarajanagara,62,2837,60,2382,398,0,46,11
2020-09-11,Chamarajanagara,45,2882,60,2442,379,4,50,11
2020-09-12,Chamarajanagara,60,2942,77,2519,360,2,52,11
2020-09-13,Chamarajanagara,80,3022,0,2519,440,0,52,11
2020-09-14,Chamarajanagara,54,3076,49,2568,443,2,54,11
2020-09-15,Chamarajanagara,38,3114,21,2589,458,2,56,11
2020-09-16,Chamarajanagara,65,3179,0,2589,524,0,55,11
2020-09-17,Chamarajanagara,108,3287,0,2589,632,0,55,11
2020-09-18,Chamarajanagara,67,3354,0,2589,699,0,55,11
2020-09-19,Chamarajanagara,72,3426,97,2686,667,7,62,11
2020-09-20,Chamarajanagara,69,3495,38,2724,698,0,62,11
2020-09-21,Chamarajanagara,57,3552,65,2789,686,4,66,11
2020-09-22,Chamarajanagara,57,3609,64,2853,678,1,67,11
2020-09-23,Chamarajanagara,32,3641,0,2853,710,0,67,11
2020-09-24,Chamarajanagara,17,3658,50,2903,675,2,69,11
2020-09-25,Chamarajanagara,51,3709,6,2909,719,1,70,11
2020-09-26,Chamarajanagara,63,3772,26,2935,756,0,70,11
2020-09-27,Chamarajanagara,38,3810,53,2988,741,0,70,11
2020-09-28,Chamarajanagara,64,3874,33,3021,771,1,71,11
2020-09-29,Chamarajanagara,122,3996,30,3051,861,2,73,11
2020-09-30,Chamarajanagara,50,4046,36,3087,871,4,77,11
2020-10-01,Chamarajanagara,116,4162,43,3130,943,1,78,11
2020-10-02,Chamarajanagara,40,4202,12,3142,971,0,78,11
2020-10-03,Chamarajanagara,179,4381,15,3157,1134,1,79,11
2020-10-04,Chamarajanagara,141,4522,7,3164,1267,1,80,11
2020-10-05,Chamarajanagara,66,4588,28,3192,1303,2,82,11
2020-10-06,Chamarajanagara,79,4667,145,3337,1237,0,82,11
2020-10-07,Chamarajanagara,104,4771,179,3516,1161,1,83,11
2020-10-08,Chamarajanagara,68,4839,167,3683,1061,1,84,11
2020-10-09,Chamarajanagara,72,4911,292,3975,841,0,84,11
2020-10-10,Chamarajanagara,79,4990,106,4081,811,3,87,11
2020-10-11,Chamarajanagara,65,5055,22,4103,854,0,87,11
2020-10-12,Chamarajanagara,70,5125,213,4316,710,1,88,11
2020-10-13,Chamarajanagara,61,5186,84,4400,685,2,90,11
2020-10-14,Chamarajanagara,97,5283,45,4445,736,1,91,11
2020-10-15,Chamarajanagara,85,5368,46,4491,773,2,93,11
2020-10-16,Chamarajanagara,62,5430,55,4546,777,3,96,11
2020-10-17,Chamarajanagara,49,5479,85,4631,739,2,98,11
2020-10-18,Chamarajanagara,60,5539,43,4674,755,1,99,11
2020-10-19,Chamarajanagara,54,5593,64,4738,740,5,104,11
2020-10-20,Chamarajanagara,32,5625,128,4866,641,3,107,11
2020-10-21,Chamarajanagara,33,5658,38,4904,636,0,107,11
2020-10-22,Chamarajanagara,29,5687,191,5095,474,0,107,11
2020-10-24,Chamarajanagara,34,5761,60,5311,329,3,110,11
2020-10-25,Chamarajanagara,22,5783,30,5341,321,0,110,11
2020-10-26,Chamarajanagara,26,5809,13,5354,334,0,110,11
2020-10-27,Chamarajanagara,34,5843,25,5379,342,1,111,11
2020-10-28,Chamarajanagara,28,5871,103,5482,266,1,112,11
2020-10-29,Chamarajanagara,37,5908,80,5562,223,0,112,11
2020-10-30,Chamarajanagara,31,5939,11,5573,243,0,112,11
2020-10-31,Chamarajanagara,28,5967,39,5612,232,0,112,11
2020-12-01,Chamarajanagara,10,6365,18,6167,71,0,116,11
2020-12-02,Chamarajanagara,16,6381,7,6174,80,0,116,11
2020-12-03,Chamarajanagara,13,6394,16,6190,77,0,116,11
2020-12-04,Chamarajanagara,24,6418,7,6197,94,0,116,11
2020-12-05,Chamarajanagara,13,6431,9,6206,98,0,116,11
2020-12-06,Chamarajanagara,20,6451,9,6215,109,0,116,11
2020-12-07,Chamarajanagara,7,6458,8,6223,108,0,116,11
2020-12-08,Chamarajanagara,15,6473,6,6229,117,0,116,11
2020-12-09,Chamarajanagara,12,6485,6,6235,123,0,116,11
2020-12-10,Chamarajanagara,22,6507,28,6263,117,0,116,11
2020-12-11,Chamarajanagara,8,6515,23,6286,102,0,116,11
2020-12-12,Chamarajanagara,20,6535,12,6298,110,0,116,11
2020-12-13,Chamarajanagara,19,6554,13,6311,116,0,116,11
2020-12-14,Chamarajanagara,7,6561,26,6337,97,0,116,11
2020-12-15,Chamarajanagara,8,6569,14,6351,91,0,116,11
2020-12-16,Chamarajanagara,17,6586,19,6370,89,0,116,11
2020-12-17,Chamarajanagara,14,6600,12,6382,91,0,116,11
2020-12-18,Chamarajanagara,20,6620,17,6399,94,0,116,11
2020-12-19,Chamarajanagara,19,6639,10,6409,102,1,117,11
2020-12-20,Chamarajanagara,16,6655,13,6422,103,2,119,11
2020-12-21,Chamarajanagara,15,6670,4,6426,114,0,119,11
2020-12-22,Chamarajanagara,3,6673,8,6434,109,0,119,11
2020-12-23,Chamarajanagara,27,6700,21,6455,115,0,119,11
2020-12-24,Chamarajanagara,9,6709,10,6465,114,0,119,11
2020-12-25,Chamarajanagara,12,6721,20,6485,106,0,119,11
2020-12-26,Chamarajanagara,10,6731,15,6500,101,0,119,11
2020-12-27,Chamarajanagara,11,6742,18,6518,94,0,119,11
2020-12-28,Chamarajanagara,8,6750,11,6529,91,0,119,11
2020-12-29,Chamarajanagara,8,6758,5,6534,94,0,119,11
2020-12-30,Chamarajanagara,12,6770,23,6557,83,0,119,11
2020-12-31,Chamarajanagara,6,6776,9,6566,80,0,119,11
2021-01-01,Chamarajanagara,12,6788,12,6578,80,0,119,11
2021-01-02,Chamarajanagara,13,6801,18,6596,75,0,119,11
2021-01-03,Chamarajanagara,9,6810,7,6603,77,0,119,11
2021-01-04,Chamarajanagara,5,6815,11,6614,71,0,119,11
2021-01-05,Chamarajanagara,5,6820,9,6623,67,0,119,11
2021-01-06,Chamarajanagara,8,6828,7,6630,68,0,119,11
2021-01-07,Chamarajanagara,5,6833,9,6639,64,0,119,11
2021-01-08,Chamarajanagara,6,6839,11,6650,59,0,119,11
2021-01-09,Chamarajanagara,5,6844,11,6661,53,0,119,11
2021-01-10,Chamarajanagara,7,6851,8,6669,52,0,119,11
2021-01-11,Chamarajanagara,2,6853,16,6685,38,0,119,11
2021-01-12,Chamarajanagara,1,6854,5,6690,34,0,119,11
2021-01-13,Chamarajanagara,5,6859,7,6697,32,0,119,11
2021-01-14,Chamarajanagara,7,6866,5,6702,34,0,119,11
2021-01-15,Chamarajanagara,6,6872,7,6709,33,0,119,11
2021-01-16,Chamarajanagara,4,6876,6,6715,31,0,119,11
2021-01-17,Chamarajanagara,4,6880,5,6720,30,0,119,11
2021-01-18,Chamarajanagara,1,6881,2,6722,29,0,119,11
2021-01-19,Chamarajanagara,2,6883,1,6723,30,0,119,11
2021-01-20,Chamarajanagara,5,6888,5,6728,30,0,119,11
2021-01-21,Chamarajanagara,1,6889,3,6731,28,0,119,11
2021-01-22,Chamarajanagara,3,6892,8,6739,23,0,119,11
2021-01-23,Chamarajanagara,4,6896,4,6743,23,0,119,11
2021-01-24,Chamarajanagara,2,6898,5,6748,20,0,119,11
2021-01-25,Chamarajanagara,5,6903,3,6751,22,0,119,11
2021-01-26,Chamarajanagara,1,6904,1,6752,22,0,119,11
2021-01-27,Chamarajanagara,3,6907,5,6757,20,0,119,11
2021-01-28,Chamarajanagara,5,6912,1,6758,24,0,119,11
2021-01-29,Chamarajanagara,4,6916,6,6764,22,0,119,11
2021-01-30,Chamarajanagara,2,6918,1,6765,23,0,119,11
2021-01-31,Chamarajanagara,2,6920,2,6767,23,0,119,11
2021-02-01,Chamarajanagara,4,6924,5,6772,22,0,119,11
2021-02-02,Chamarajanagara,0,6924,1,6773,21,0,119,11
2021-02-03,Chamarajanagara,1,6925,4,6777,18,0,119,11
2021-02-04,Chamarajanagara,3,6928,5,6782,16,0,119,11
2021-02-05,Chamarajanagara,4,6932,3,6785,17,0,119,11
2021-02-06,Chamarajanagara,4,6936,2,6787,18,1,120,11
2021-02-07,Chamarajanagara,1,6937,1,6788,18,0,120,11
2021-02-08,Chamarajanagara,3,6940,3,6791,18,0,120,11
2021-02-09,Chamarajanagara,0,6940,3,6794,15,0,120,11
2021-02-10,Chamarajanagara,3,6943,1,6795,17,0,120,11
2021-02-11,Chamarajanagara,1,6944,3,6798,15,0,120,11
2021-02-12,Chamarajanagara,2,6946,4,6802,13,0,120,11
2021-02-13,Chamarajanagara,2,6948,5,6807,10,0,120,11
2021-02-14,Chamarajanagara,1,6949,0,6807,11,0,120,11
2021-02-15,Chamarajanagara,0,6949,2,6809,9,0,120,11
2021-02-16,Chamarajanagara,1,6950,0,6809,10,0,120,11
2021-02-17,Chamarajanagara,5,6955,1,6810,14,0,120,11
2021-02-18,Chamarajanagara,1,6956,4,6814,11,0,120,11
2021-02-19,Chamarajanagara,2,6958,2,6816,11,0,120,11
2021-02-20,Chamarajanagara,3,6961,3,6819,11,0,120,11
2021-02-21,Chamarajanagara,0,6961,0,6819,11,0,120,11
2021-02-22,Chamarajanagara,0,6961,2,6821,9,0,120,11
2021-02-23,Chamarajanagara,0,6961,3,6824,6,0,120,11
2021-02-24,Chamarajanagara,2,6963,0,6824,8,0,120,11
2021-02-25,Chamarajanagara,0,6963,1,6825,7,0,120,11
2021-02-26,Chamarajanagara,7,6970,2,6827,12,0,120,11
2021-02-27,Chamarajanagara,4,6974,2,6829,14,0,120,11
2021-02-28,Chamarajanagara,3,6977,0,6829,17,0,120,11
2021-03-01,Chamarajanagara,0,6977,3,6832,14,0,120,11
2021-03-02,Chamarajanagara,2,6979,0,6832,16,0,120,11
2021-03-03,Chamarajanagara,9,6988,2,6834,23,0,120,11
2021-03-04,Chamarajanagara,2,6990,3,6837,22,0,120,11
2021-03-05,Chamarajanagara,2,6992,3,6840,21,0,120,11
2021-03-06,Chamarajanagara,3,6995,3,6843,21,0,120,11
2021-03-07,Chamarajanagara,3,6998,2,6845,22,0,120,11
2021-03-08,Chamarajanagara,1,6999,2,6847,21,0,120,11
2021-03-09,Chamarajanagara,1,7000,2,6849,20,0,120,11
2021-03-10,Chamarajanagara,3,7003,8,6857,15,0,120,11
2021-03-11,Chamarajanagara,3,7006,4,6861,14,0,120,11
2021-03-12,Chamarajanagara,1,7007,1,6862,14,0,120,11
2021-03-13,Chamarajanagara,0,7007,5,6867,9,0,120,11
2021-03-14,Chamarajanagara,0,7007,0,6867,9,0,120,11
2021-03-15,Chamarajanagara,7,7014,3,6870,13,0,120,11
2021-03-16,Chamarajanagara,0,7014,1,6871,12,0,120,11
2021-03-17,Chamarajanagara,4,7018,0,6871,16,0,120,11
2021-03-18,Chamarajanagara,5,7023,2,6873,19,0,120,11
2021-03-19,Chamarajanagara,8,7031,1,6874,26,0,120,11
2021-03-20,Chamarajanagara,4,7035,4,6878,26,0,120,11
2021-03-21,Chamarajanagara,4,7039,0,6878,30,0,120,11
2021-03-22,Chamarajanagara,3,7042,4,6882,29,0,120,11
2021-03-23,Chamarajanagara,0,7042,0,6882,29,0,120,11
2021-03-24,Chamarajanagara,5,7047,3,6885,31,0,120,11
2021-03-25,Chamarajanagara,4,7051,4,6889,31,0,120,11
2021-03-26,Chamarajanagara,1,7052,11,6900,21,0,120,11
2021-03-27,Chamarajanagara,7,7059,1,6901,27,0,120,11
2021-03-28,Chamarajanagara,9,7068,5,6906,31,0,120,11
2021-03-29,Chamarajanagara,4,7072,2,6908,33,0,120,11
2021-03-30,Chamarajanagara,3,7075,0,6908,36,0,120,11
2021-03-31,Chamarajanagara,3,7078,5,6913,34,0,120,11
2021-04-01,Chamarajanagara,17,7095,3,6916,48,0,120,11
2021-04-02,Chamarajanagara,13,7108,4,6920,57,0,120,11
2021-04-03,Chamarajanagara,18,7126,6,6926,69,0,120,11
2021-04-04,Chamarajanagara,15,7141,8,6934,76,0,120,11
2021-04-05,Chamarajanagara,30,7171,4,6938,102,0,120,11
2021-04-06,Chamarajanagara,5,7176,3,6941,104,0,120,11
2021-04-07,Chamarajanagara,39,7215,4,6945,139,0,120,11
2021-04-08,Chamarajanagara,56,7271,19,6964,176,0,120,11
2021-04-09,Chamarajanagara,35,7306,11,6975,200,0,120,11
2021-04-10,Chamarajanagara,35,7341,14,6989,220,1,121,11
2021-04-11,Chamarajanagara,49,7390,12,7001,257,0,121,11
2021-04-12,Chamarajanagara,39,7429,28,7029,266,2,123,11
2021-04-13,Chamarajanagara,51,7480,11,7040,306,0,123,11
2021-04-14,Chamarajanagara,72,7552,50,7090,328,0,123,11
2021-04-15,Chamarajanagara,39,7591,54,7144,313,0,123,11
2021-04-16,Chamarajanagara,68,7659,29,7173,352,0,123,11
2021-04-17,Chamarajanagara,136,7795,25,7198,461,2,125,11
2021-04-18,Chamarajanagara,102,7897,56,7254,506,1,126,11
2021-04-19,Chamarajanagara,108,8005,35,7289,579,0,126,11
2021-04-20,Chamarajanagara,99,8104,40,7329,637,1,127,11
2021-04-21,Chamarajanagara,170,8274,73,7402,734,0,127,11
2021-04-22,Chamarajanagara,271,8545,33,7435,972,0,127,11
2021-04-23,Chamarajanagara,249,8794,78,7513,1141,2,129,11
2021-04-24,Chamarajanagara,295,9089,109,7622,1326,1,130,11
2021-04-25,Chamarajanagara,284,9373,81,7703,1528,1,131,11
2021-04-26,Chamarajanagara,267,9640,119,7822,1673,3,134,11
2021-04-27,Chamarajanagara,212,9852,77,7899,1806,2,136,11
2021-04-28,Chamarajanagara,424,10276,206,8105,2021,3,139,11
2021-04-29,Chamarajanagara,359,10635,212,8317,2161,7,146,11
2021-04-30,Chamarajanagara,474,11109,239,8556,2390,6,152,11
2021-05-01,Chamarajanagara,548,11657,242,8798,2696,0,152,11
2021-05-02,Chamarajanagara,271,11928,308,9106,2644,15,167,11
2021-05-03,Chamarajanagara,724,12652,251,9357,3098,19,186,11
2021-05-04,Chamarajanagara,528,13180,229,9586,3389,8,194,11
2021-05-05,Chamarajanagara,542,13722,382,9968,3544,5,199,11
2021-05-06,Chamarajanagara,707,14429,378,10346,3868,5,204,11
2021-05-07,Chamarajanagara,725,15154,389,10735,4197,7,211,11
2021-05-08,Chamarajanagara,691,15845,492,11227,4394,2,213,11
2021-05-09,Chamarajanagara,930,16775,561,11788,4748,15,228,11
2021-05-10,Chamarajanagara,623,17398,611,12399,4753,7,235,11
2021-05-11,Chamarajanagara,411,17809,397,12796,4755,12,247,11
2021-05-12,Chamarajanagara,517,18326,681,13477,4583,8,255,11
2021-05-13,Chamarajanagara,842,19168,652,14129,4768,5,260,11
2021-05-14,Chamarajanagara,713,19881,575,14704,4900,6,266,11
2021-05-15,Chamarajanagara,535,20416,793,15497,4634,8,274,11
2021-05-16,Chamarajanagara,440,20856,819,16316,4247,8,282,11
2021-05-17,Chamarajanagara,516,21372,600,16916,4155,8,290,11
2021-05-18,Chamarajanagara,345,21717,359,17275,4133,8,298,11
2021-05-19,Chamarajanagara,576,22293,665,17940,4036,8,306,11
2021-05-20,Chamarajanagara,541,22834,572,18512,3999,6,312,11
2021-05-21,Chamarajanagara,470,23304,714,19226,3751,4,316,11
2021-05-22,Chamarajanagara,412,23716,632,19858,3524,7,323,11
2021-05-23,Chamarajanagara,407,24123,409,20267,3518,4,327,11
2021-05-24,Chamarajanagara,439,24562,595,20862,3349,13,340,11
2021-05-25,Chamarajanagara,282,24844,287,21149,3336,8,348,11
2021-05-26,Chamarajanagara,425,25269,578,21727,3170,13,361,11
2021-05-27,Chamarajanagara,380,25649,259,21986,3282,9,370,11
2021-05-28,Chamarajanagara,318,25967,430,22416,3166,4,374,11
2021-05-29,Chamarajanagara,365,26332,435,22851,3089,7,381,11
2021-05-30,Chamarajanagara,402,26734,386,23237,3100,5,386,11
2021-05-31,Chamarajanagara,317,27051,355,23592,3059,3,389,11
2021-06-01,Chamarajanagara,80,27131,434,24026,2702,3,392,11
2021-06-02,Chamarajanagara,258,27389,163,24189,2793,4,396,11
2021-06-03,Chamarajanagara,313,27702,332,24521,2764,10,406,11
2021-06-04,Chamarajanagara,296,27998,278,24799,2778,4,410,11
2021-06-05,Chamarajanagara,340,28338,266,25065,2846,6,416,11
2021-06-06,Chamarajanagara,247,28585,314,25379,2773,6,422,11
2021-06-07,Chamarajanagara,209,28794,196,25575,2785,1,423,11
2021-06-08,Chamarajanagara,106,28900,372,25947,2516,3,426,11
2021-06-09,Chamarajanagara,254,29154,515,26462,2250,5,431,11
2021-06-10,Chamarajanagara,274,29428,534,26996,1989,1,432,11
2021-06-11,Chamarajanagara,162,29590,647,27643,1503,1,433,11
2021-06-12,Chamarajanagara,176,29766,216,27859,1463,0,433,11
2021-06-13,Chamarajanagara,129,29895,238,28097,1351,3,436,11
2021-06-14,Chamarajanagara,119,30014,199,28296,1271,0,436,11
2021-06-15,Chamarajanagara,79,30093,139,28435,1211,0,436,11
2021-06-16,Chamarajanagara,97,30190,209,28644,1098,1,437,11
2021-06-17,Chamarajanagara,98,30288,169,28813,1023,4,441,11
2021-06-18,Chamarajanagara,83,30371,188,29001,918,0,441,11
2021-06-19,Chamarajanagara,113,30484,175,29176,855,1,442,11
2021-06-20,Chamarajanagara,61,30545,84,29260,831,1,443,11
2021-06-21,Chamarajanagara,109,30654,132,29392,807,1,444,11
2021-06-22,Chamarajanagara,52,30706,90,29482,769,0,444,11
2021-06-23,Chamarajanagara,89,30795,76,29558,782,0,444,11
2021-06-24,Chamarajanagara,64,30859,99,29657,746,1,445,11
2021-06-25,Chamarajanagara,71,30930,88,29745,727,2,447,11
2021-06-26,Chamarajanagara,71,31001,93,29838,702,3,450,11
2021-06-27,Chamarajanagara,54,31055,68,29906,687,1,451,11
